12,10
%%%%%%%%%%
%%-----%%%
%%G--%-%%%
%%%%-%-%-%
%-%-%--%-%
%-%-%%---%
%-%-%-%-%%
%---%-%--%
%-%-%-%%-%
%-%-%-%--%
%-%-%-%S%%
%%%%%%%%%%